VVVVVVVVVVVVVVVVVVVVVVVVVVVVVVVVVVVVVVVVVVVVVVVVVVVVVVVVVVVV
VVVVVVVVVVVBBBBBBBBBBBBBBBBBBBBBBBBBBBBBBVVVVVVVVVVVVVVVVVVV
VVVVVVVVVVVVVVVVVVVAAAAAAAAAAAAAAVVVVVVVVVVVVVVVVVVVVVVVVVVV
VVVVVVVVVVVBVVVVVVVVVVVVVVVBVVVVVVVVVVVVVVVVVVVVVBVVVVVVVVVV
VVVVVVVVVVVVVVVVVVVVVVVVVVVVVVVVVVVVVVVVVVVVVVVVVVVVVVVVVVVV
VVVVVVVVVVVVVVVVVVVAAAAAAAAAAAAAAVVVVVVVVVVVVVVVVVVVVVVVVVVV
VVVVVVVVVVVVVVVVVVVAAAAAAAAAAAAAAVVVVVVVVVVVVVVVVVVVVVVVVVVV
VVVVVVVVVVVVVVVVVVVAAAAAAAAAAAAAAVVVVVVVVVVVVVVVVVVVVVVVVVVV
VVVVVVVVVVVVVVVVVVVAAAAAAAAAAAAAAVVVBVVVVVVVVVVVVVVVVVVVVVVV
VVVVVVVVBVVVVVVVVVVAAAAAAAAAAAAAAVVVVVVVVVVVVVVVVVVVVVVVVVVV
VVVVVVVVVVVVVVVVVVVAAAAAAAAAAAAAAVVVVVVVVVVVVVVVVVVVVVVVVVVV
VVVVVVVVVVVVVVVVVVVAAAAAAAAAAAAAAVVVVVVVVVVVVVVVVVVVVVVVVVVV
VVVVVVVVVVVVVVVVVVVVVVVVVVBVVVVVVVVVVVVVVVVVVVVVVVVVVVVVVVVV
VVVVVVVVVVVVVVVVVVVAAAAAAAAAAAAAAVVVVVVVVVVVVVVVVVVVVVVVVVVV
VVVVVVVVVVVVVVVVVVVAAAAAAAAAAAAAAVVVVVVVVVVVVVVVVBVVVVVVVVVV
VVVVVVVVVVVVVVVVVVVAAAAAAAAAAAAAAVVVVVVVVVVVVVVVVVVVVVVVVVVV
VVVVVVVVVVVVVVVVVVVAAAAAAAAAAAAAAVVVVVVVVVVVVVVVVVVVVVVVVVVV
VVVVVVVVVVVVVVVVVVVAAAAAAAAAAAAAAVVVVVVVVVVVVVVVVVVVVVVVVVVV
VVVVVVVVVVVVVVVVVVVAAAAAAAAAAAAAAVVVVVVVVVVVVVVBVVVVVVVVVVVV
VVVVVVVVVBVVVVVVVVVAAAAAAAAAAAAAAVVVVVVVVVVVVVVVVVVVVVVVVVVV
VVVVVVVVVVVVVVVVVVVAAAAAAAAAAAAAAVVVVVVVBVVVVVVVVVVVVVVVVVVV
VVVVVVVVVVVVVVVVVVVAAAAAAAAAAAAAAVVVVVVVVVVVVVVVVVVVVVVVVVVV
VVVVVVVVVVVVVVVVVVVAAAAAAAAAAAAAAVVVVVVVVVVVVVVVVVVVVVVVVVVV
VVVVVVVVVVVVVVVVVVVAAAAAAAAAAAAAAVVVVVVVVVVVVVVVVVVVVVVVVVVV
VVVVVVVVVVVVVVVVVVVAAAAAAAAAAAAAAVVVVVVVVVVVVVVVVVVVVVVVVVVV
VVVVVVVVVVVVVVVVBVVAAAAAAAAAAAAAAVVVVVVVVVVVVVVVVBVVVVVVVVVV
VVVVVVVVVVVVVVVVVVVAAAAAAAAAAAAAAVVVVVVVVVVVVVVVVVVVVVVVVVVV
VVVVVVVVVVVVVVVVVVVAAAAAAAAAAAAAAVVVVVVVVVVVVVVVVVVVVVVVVVVV
VVVVVVVVVVVVVVVVVVVAAAAAAAAAAAAAAVVVVVVVVVVVVVVVVVVVVVVVVVVV
VVVVVVVVVVVVVVVVVVVAAAAAAAAAAAAAAVVVVVVVVVVVVVVVVVVVVVVVVVVV
VVVVVVVVVVVVVVVVVVVAAAAAAAAAAAAAAVVVVVVVVVVVVVVVVVVVVVVVVVVV
VVVVVVVVVVVVVVVVVVVAAAAAAAAAAAAAAVVVVVVVBVVVVVVVVVVVVVVVVVVV
VVVVVVVVVVVVVVVVVVVAAAAAAAAAAAAAAVVVVVVVVVVVVVVVVVVVVVVVVVVV
VVVVVVVVVVVVVVVVVVVAAAAAAAAAAAAAAVVVVVVVVVVVVVVVVVVVVVVVVVVV
VVVVVVBVVVVVVVVVBVVAAAAAAAAAAAAAAVVVVVVVVVVVVVVBVVVVVVVVVVVV
VVVVVVVVVVVVVVVVVVVAAAAAAAAAAAAAAVVVVVVVVVVVVVVVVVVVVVVVVVVV
VVVVVVVVVVVVVVVVVVVAAAAAAAAAAAAAAVVVVVVVVVVVVVVVVVVVVVVVVVVV
VVVVVVVVVVVVVVVVVVVAAAAAAAAAAAAAAVVVVVVBVVVVVVVVVVVVVVVVVVVV
VVVVVVVVVVVVVVVVVVVAAAAAAAAAAAAAAVVVVVVVVVVVVVVVVVVVVVVVVVVV
VVVVVVVVVVVVVVVVVVVAAAAAAAAAAAAAAVVVVVVVVVVVVVVVVVVVVVVVVVVV
VVVVVVVVVVBVVVVVVVVAAAAAAAAAAAAAAVVVVVVVVVVVVVVVVVVVVVVVVVVV
VVVVVVVVVVVVVVVVVVVAAAAAAAAAAAAAAVVVVVVVVVVVVVVVVVVVVBVVVVVV
VVVVVVVVVVVVVVVVVVVAAAAAAAAAAAAAAVVVVVVVVVVVVVVVVVVVVVVVVVVV
VVVVVVVVVBVVVVVVVVVAAAAAAAAAAAAAAVVVVVVVVVVVVVVVVVVVVVVVVVVV
VVVVVVVVVVVVVVVVVVVAAAAAAAAAAAAAAVVVVVVVVVVVVVVVVVVVVVVVVVVV
VVVVVVVVVVVVVVVVVVVAAAAAAAAAAAAAAVVVVVVVVVVVVVVBVVVVVVVVVVVV
VVVVVVVVVVVVVVVVVVVAAAAAAAAAAAAAAVVVVVVVVVVVVVVVVVVVVVVVVVVV
VVVVVVVVVVVVVVVVVVVAAAAAAAAAAAAAAVVVVVVVVVVVVVVVVVVVVVVVVVVV
VVVVVVVVVVVVVVVVVVVAAAAAAAAAAAAAAVVVVVVVVVVVVVVVVVVVVVVVVVVV
VVVVVVVVVVVVVVVVVVVAAAAAAAAAAAAAAVVVVVVVVVVVVVVVVVVVVVVVVVVV
VVVVVVVVVVVVVVVVVVVAAAAAAAAAAAAAAVVVVVVVVVVVVVVVVVVVVVVVVVVV
VVVVVVVVVVVVVVVVVVVAAAAAAAAAAAAAAVVVVVVVVVVVVVVVVVVVVVVVVVVV
VVVVVVVVVVVVVVVVVVVAAAAAAAAAAAAAAVVVVVVVVVVVVVVVVVVVVVVVVVVV
VVVVVVVVVVVVVVVVVVVAAAAAAAAAAAAAAVVVVVVVVVVVVVVVVVVVVVVVVVVV
VVVVVVVVVVBVVVVVVVVAAAAAAAAAAAAAAVVVVVVBVVVVVVVVVVVVVVVVVVVV
VVVVVVVVVVVVVVVVVVVAAAAAAAAAAAAAAVVVVVVVVVVVVVVVVVVVVVVVVVVV
VVVVVVVVVVVVVVVVVVVAAAAAAAAAAAAAAVVVVVVVVVVVVVVVVVVVVVVVVVVV
VVVVVVVVVVVVVVVVVVVAAAAAAAAAAAAAAVVVVVVVVVVVVVVVVVVVVVVVVVVV
VVVVVVVVVVVVVVVVVVVAAAAAAAAAAAAAAVVVVVVVVVVVVVVVVVVVVVVVVVVV
VVVVVVVVVBVVVVVVVVVAAAAAAAAAAAAAAVVVVVVVVVVVVVVVVVVVVVVVVVVV
VVVVVVVVVVVVVVVVVVVAAAAAAAAAAAAAAVVVVVVVVVVVBVVVVVVVVVVVVVVV
VVVVVVVVVVVVVVVVVVVAAAAAAAAAAAAAAVVVVVVVVVVVVVVVVVVVVVVVVVVV
VVVVVVVVVVVVVVVVVVVAAAAAAAAAAAAAAVVVVVVVVVVVVVVVVVVVVVVVVVVV
VVVVVVVVVVVVVVVVVVVAAAAAAAAAAAAAAVVVVVVVVVVVVVVVVVVVVVVVVVVV
VVVVVVVVVVVVVVVVVVVAAAAAAAAAAAAAAVVVVVVVVVVVVBVVVVVVVVVVVVVV
VVVVVVVVVVVVVVVVVVVAAAAAAAAAAAAAAVVVVVVVVVVVVVVVVVVVVVVVVVVV
VVVVVVVVVVVVVVVVVVVAAAAAAAAAAAAAAVVVVVVVVVVVVVVVVVVVVVVVVVVV
VVVVVVVVVVVVVVVVVVVAAAAAAAAAAAAAAVVVVVVVVVVVVVVVVVVVVVVVVVVV
VVVVVVVVVVVVVVVVVVVAAAAAAAAAAAAAAVVVVVVVVVVVVVVVVVVVVVVVVVVV
VVVVVVVVVVVVVVVVVVVAAAAAAAAAAAAAAVVVBVVVVVVVVVVVVVVVVVVVVVVV
VVVVVVVVVVVVVVVVVVVAAAAAAAAAAAAAAVVVVVVVVVVVVVVVVVVVVVVVVVVV
VVVVVVVVVVVVVVVVVVVAAAAAAAAAAAAAAVVVVVVVVVVVVVVVVVVVVVVVVVVV
VVVVVVVVVVVVVVVVVVVAAAAAAAAAAAAAAVVVVVVVVVVVVVVVVVVVVVVVVVVV
VVVVVVVVVVVVVVVVVVVAAAAAAAAAAAAAAVVVVVVVVVVVVVVVVVVVVVVVVVVV
VVVVVVVVVVVVVVVVVVVAAAAAAAAAAAAAAVVVVVVVVVVVVVVVVVVVVVVVVVVV
VVVVVVVVVVBVVVVVVVVAAAAAAAAAAAAAAVVVVVVVVVVVVVVVVVVVVVVVVVVV
VVVVVVVVVVVVVVVVVVVAAAAAAAAAAAAAAVVVVVVVVVVVVVVVVVVVVVVVVVVV
VVVVVVVVVVVVVVVVVVVAAAAAAAAAAAAAAVVVVVVVVVVVVVVVVVVVVVVVVVVV
VVVVVVVVVVVVVVVVVVVVVVVVVVVVVVVVVVVVVVVVVVVVVVVVVVVVVVVVVVVV
VVVVVVVVVVVVVVVVVVVVVVVVVVVVVVVVAAAAAEEEVVVVVVVVVVVVVVVVVVVS
LVVVVVVVVVVVVVVVVVVAAAAAAAAAAAAAAVVVVVVVVVVVVVVVVVVVVVVVVVVV
VVVVVVVVVVVVVVVVVVVAAAAAAAAAAAAAAVVVVVVVVVVVVVVVVVVBVVVVVVVV
VVVVVVVVVVVVVVVVVVVAAAAAAAAAAAAAAVVVVVVVVVVVVVVVVVVVVVVVVVVV
VVVVVVVVVBVVVVVVVVVAAAAAAAAAAAAAAVVVVVVVVVVVVVVVVVVVVBVVVVVV
VVVVVVVVVVVVVVVVVVVAAAAAAAAAAAAAAVVVVVVVVVVVVVVVVVVBBVVVVVVV
VVVVVVVVVVVVVVVVVVVVVVVVVVVVVVVVVVVVVVVVVVVVVVVVVVVVVVVVVVVV
VVVVVVVVVBVVVVVVVVVVVVVVVVVVVVVVAAAAAEEEVVVVVVVVVVVVVVVVVVVV
VVVVVVVVVVVVVVVVVVVAAAAAAAAAAAAAAVVVVVVVVVVVVVVVVVVBBBVVVVVV
VVVVVVVVVVVVVVVVVVVAAAAAAAAAAAAAAVVVVVVVVVVVVVVVVVVBBBVVVVVV
VVVVVVVVVVVVVVVVVVVAAAAAAAAAAAAAAVVVVVVVVVVVVVVVVVVBBBVVVVVV