VVVVVVVVVVVVVVVVVVVVVVVVVVVVVVVVVVVVVVVVVVVVVVVVVVVVVVVVVVVV
VVVVVVVVVVVBBBBBBBBBBBBBBBBBBBBBBBBBBBBBBVVVVVVVVVVVVVVVVVVV
VVVVVVVVVVVVVVVVVVVAAAAAAAAAAAAAAVVVVVVVVVVVVVVVVVVBBBVVVVVV
VVVVVVVVVVVVVVVVVVVVVVVVVVVVVVVVVVVVVVVVVVVVVVVVVVVVVVVVVVVV
VVVVVVVVVVVVVVVVVVVVVVVVVVVVVVVVVVVVVVVVVVVVVVVVVVVVVVVVVVVV
VVVVVVVVVVVVVVVVVVVAAAAAAAAAAAAAAVVVVVVVVVVVVVVVVVVBBBVVVVVV
VVVVVVVVVVVVVVVVVVVAAAAAAAAAAAAAAVVVVVVVVVVVVVVVVVVBBBVVVVVV
VVVVVVVVVVVVVVVVVVVAAAAAAAAAAAAAAVVVVVVVVVVVVVVVVVVBBBVVVVVV
VVVVVVVVVVVVVVVVVVVAAAAAAAAAAAAAAVVVVVVVVVVVVVVVVVVBBBVVVVVV
VVVVVVVVVVVVVVVVVVVAAAAAAAAAAAAAAVVVVVVVVVVVVVVVVVVBBBVVVVVV
VVVVVVVVVVVVVVVVVVVAAAAAAAAAAAAAAVVVVVVVVVVVVVVVVVVBBBVVVVVV
VVVVVVVVVVVVVVVVVVVAAAAAAAAAAAAAAVVVVVVVVVVVVVVVVVVBBBVVVVVV
VVVVVVVVVVVVVVVVVVVAAAAAAAAAAAAAAVVVVVVVVVVVVVVVVVVBBBVVVVVV
VVVVVVVVVVVVVVVVVVVAAAAAAAAAAAAAAVVVVVVVVVVVVVVVVVVBBBVVVVVV
VVVVVVVVVVVVVVVVVVVAAAAAAAAAAAAAAVVVVVVVVVVVVVVVVVVBBBVVVVVV
VVVVVVVVVVVVVVVVVVVAAAAAAAAAAAAAAVVVVVVVVVVVVVVVVVVBBBVVVVVV
VVVVVVVVVVVVVVVVVVVAAAAAAAAAAAAAAVVVVVVVVVVVVVVVVVVBBBVVVVVV
VVVVVVVVVVVVVVVVVVVAAAAAAAAAAAAAAVVVVVVVVVVVVVVVVVVBBBVVVVVV
VVVVVVVVVVVVVVVVVVVAAAAAAAAAAAAAAVVVVVVVVVVVVVVVVVVBBBVVVVVV
VVVVVVVVVVVVVVVVVVVAAAAAAAAAAAAAAVVVVVVVVVVVVVVVVVVBBBVVVVVV
VVVVVVVVVVVVVVVVVVVAAAAAAAAAAAAAAVVVVVVVVVVVVVVVVVVBBBVVVVVV
VVVVVVVVVVVVVVVVVVVAAAAAAAAAAAAAAVVVVVVVVVVVVVVVVVVBBBVVVVVV
VVVVVVVVVVVVVVVVVVVAAAAAAAAAAAAAAVVVVVVVVVVVVVVVVVVBBBVVVVVV
VVVVVVVVVVVVVVVVVVVAAAAAAAAAAAAAAVVVVVVVVVVVVVVVVVVBBBVVVVVV
VVVVVVVVVVVVVVVVVVVAAAAAAAAAAAAAAVVVVVVVVVVVVVVVVVVBBBVVVVVV
VVVVVVVVVVVVVVVVVVVAAAAAAAAAAAAAAVVVVVVVVVVVVVVVVVVBBBVVVVVV
VVVVVVVVVVVVVVVVVVVAAAAAAAAAAAAAAVVVVVVVVVVVVVVVVVVBBBVVVVVV
VVVVVVVVVVVVVVVVVVVAAAAAAAAAAAAAAVVVVVVVVVVVVVVVVVVBBBVVVVVV
VVVVVVVVVVVVVVVVVVVAAAAAAAAAAAAAAVVVVVVVVVVVVVVVVVVBBBVVVVVV
VVVVVVVVVVVVVVVVVVVAAAAAAAAAAAAAAVVVVVVVVVVVVVVVVVVBBBVVVVVV
VVVVVVVVVVVVVVVVVVVAAAAAAAAAAAAAAVVVVVVVVVVVVVVVVVVBBBVVVVVV
VVVVVVVVVVVVVVVVVVVAAAAAAAAAAAAAAVVVVVVVVVVVVVVVVVVBBBVVVVVV
VVVVVVVVVVVVVVVVVVVAAAAAAAAAAAAAAVVVVVVVVVVVVVVVVVVBBBVVVVVV
VVVVVVVVVVVVVVVVVVVAAAAAAAAAAAAAAVVVVVVVVVVVVVVVVVVBBBVVVVVV
VVVVVVVVVVVVVVVVVVVAAAAAAAAAAAAAAVVVVVVVVVVVVVVVVVVBBBVVVVVV
VVVVVVVVVVVVVVVVVVVAAAAAAAAAAAAAAVVVVVVVVVVVVVVVVVVBBBVVVVVV
VVVVVVVVVVVVVVVVVVVAAAAAAAAAAAAAAVVVVVVVVVVVVVVVVVVBBBVVVVVV
VVVVVVVVVVVVVVVVVVVAAAAAAAAAAAAAAVVVVVVVVVVVVVVVVVVBBBVVVVVV
VVVVVVVVVVVVVVVVVVVAAAAAAAAAAAAAAVVVVVVVVVVVVVVVVVVBBBVVVVVV
VVVVVVVVVVVVVVVVVVVAAAAAAAAAAAAAAVVVVVVVVVVVVVVVVVVBBBVVVVVV
VVVVVVVVVVVVVVVVVVVAAAAAAAAAAAAAAVVVVVVVVVVVVVVVVVVBBBVVVVVV
VVVVVVVVVVVVVVVVVVVAAAAAAAAAAAAAAVVVVVVVVVVVVVVVVVVBBBVVVVVV
VVVVVVVVVVVVVVVVVVVAAAAAAAAAAAAAAVVVVVVVVVVVVVVVVVVBBBVVVVVV
VVVVVVVVVVVVVVVVVVVAAAAAAAAAAAAAAVVVVVVVVVVVVVVVVVVBBBVVVVVV
VVVVVVVVVVVVVVVVVVVAAAAAAAAAAAAAAVVVVVVVVVVVVVVVVVVBBBVVVVVV
VVVVVVVVVVVVVVVVVVVAAAAAAAAAAAAAAVVVVVVVVVVVVVVVVVVBBBVVVVVV
VVVVVVVVVVVVVVVVVVVAAAAAAAAAAAAAAVVVVVVVVVVVVVVVVVVBBBVVVVVV
VVVVVVVVVVVVVVVVVVVAAAAAAAAAAAAAAVVVVVVVVVVVVVVVVVVBBBVVVVVV
VVVVVVVVVVVVVVVVVVVAAAAAAAAAAAAAAVVVVVVVVVVVVVVVVVVBBBVVVVVV
VVVVVVVVVVVVVVVVVVVAAAAAAAAAAAAAAVVVVVVVVVVVVVVVVVVBBBVVVVVV
VVVVVVVVVVVVVVVVVVVAAAAAAAAAAAAAAVVVVVVVVVVVVVVVVVVBBBVVVVVV
VVVVVVVVVVVVVVVVVVVAAAAAAAAAAAAAAVVVVVVVVVVVVVVVVVVBBBVVVVVV
VVVVVVVVVVVVVVVVVVVAAAAAAAAAAAAAAVVVVVVVVVVVVVVVVVVBBBVVVVVV
VVVVVVVVVVVVVVVVVVVAAAAAAAAAAAAAAVVVVVVVVVVVVVVVVVVBBBVVVVVB
VVVVVVVVVVVVVVVVVVVAAAAAAAAAAAAAAVVVVVVVVVVVVVVVVVVBBBVVVVVV
VVVVVVVVVVVVVVVVVVVAAAAAAAAAAAAAAVVVVVVVVVVVVVVVVVVBBBVVVVVV
VVVVVVVVVVVVVVVVVVVAAAAAAAAAAAAAAVVVVVVVVVVVVVVVVVVBBBVVVVVV
VVVVVVVVVVVVVVVVVVVAAAAAAAAAAAAAAVVVVVVVVVVVVVVVVVVBBBVVVVVV
VVVVVVVVVVVVVVVVVVVAAAAAAAAAAAAAAVVVVVVVVVVVVVVVVVVBBBVVVVVV
VVVVVVVVVVVVVVVVVVVAAAAAAAAAAAAAAVVVVVVVVVVVVVVVVVVBBBVVVVVV
VVVVVVVVVVVVVVVVVVVAAAAAAAAAAAAAAVVVVVVVVVVVVVVVVVVBBVVVVVVV
VVVVVVVVVVVVVVVVVVVAAAAAAAAAAAAAAVVVVVVVVVVVVVVVVVVBBBVVVVVV
VVVVVVVVVVVVVVVVVVVAAAAAAAAAAAAAAVVVVVVVVVVVVVVVVVVBBBVVVVVV
VVVVVVVVVVVVVVVVVVVAAAAAAAAAAAAAAVVVVVVVVVVVVVVVVVVBBBVVVVVV
VVVVVVVVVVVVVVVVVVVAAAAAAAAAAAAAAVVVVVVVVVVVVVVVVVVBBBVVVVVV
VVVVVVVVVVVVVVVVVVVAAAAAAAAAAAAAAVVVVVVVVVVVVVVVVVVBBBVVVVVV
VVVVVVVVVVVVVVVVVVVAAAAAAAAAAAAAAVVVVVVVVVVVVVVVVVVBBBVVVVVV
VVVVVVVVVVVVVVVVVVVAAAAAAAAAAAAAAVVVVVVVVVVVVVVVVVVBBBVVVVVV
VVVVVVVVVVVVVVVVVVVAAAAAAAAAAAAAAVVVVVVVVVVVVVVVVVVBBBVVVVVV
VVVVVVVVVVVVVVVVVVVAAAAAAAAAAAAAAVVVVVVVVVVVVVVVVVVBBBVVVVVV
VVVVVVVVVVVVVVVVVVVAAAAAAAAAAAAAAVVVVVVVVVVVVVVVVVVBBBVVVVVV
VVVVVVVVVVVVVVVVVVVAAAAAAAAAAAAAAVVVVVVVVVVVVVVVVVVBBBVVVVVV
VVVVVVVVVVVVVVVVVVVAAAAAAAAAAAAAAVVVVVVVVVVVVVVVVVVBBBVVVVVV
VVVVVVVVVVVVVVVVVVVAAAAAAAAAAAAAAVVVVVVVVVVVVVVVVVVBBBVVVVVV
VVVVVVVVVVVVVVVVVVVAAAAAAAAAAAAAAVVVVVVVVVVVVVVVVVVBBBVVVVVV
VVVVVVVVVVVVVVVVVVVAAAAAAAAAAAAAAVVVVVVVVVVVVVVVVVVBBBVVVVVV
VVVVVVVVVVVVVVVVVVVAAAAAAAAAAAAAAVVVVVVVVVVVVVVVVVVBBBVVVVVV
VVVVVVVVVVVVVVVVVVVAAAAAAAAAAAAAAVVVVVVVVVVVVVVVVVVBBBVVVVVV
VVVVVVVVVVVVVVVVVVVVVVVVVVVVVVVVVVVVVVVVVVVVVVVVVVVVVVVVVVVV
VVVVVVVVVVVVVVVVVVVVVVVVVVVVVVVVAAAAAEEEVVVVVVVVVVVVVVVVVVVS
LVVVVVVVVVVVVVVVVVVAAAAAAAAAAAAAAVVVVVVVVVVVVVVVVVVBBBVVVVVV
VVVVVVVVVVVVVVVVVVVAAAAAAAAAAAAAAVVVVVVVVVVVVVVVVVVBBBVVVVVV
VVVVVVVVVVVVVVVVVVVAAAAAAAAAAAAAAVVVVVVVVVVVVVVVVVVBBBVVVVVV
VVVVVVVVVVVVVVVVVVVAAAAAAAAAAAAAAVVVVVVVVVVVVVVVVVVBBBVVVVVV
VVVVVVVVVVVVVVVVVVVAAAAAAAAAAAAAAVVVVVVVVVVVVVVVVVVBBBVVVVVV
VVVVVVVVVVVVVVVVVVVVVVVVVVVVVVVVVVVVVVVVVVVVVVVVVVVVVVVVVVVV
VVVVVVVVVVVVVVVVVVVVVVVVVVVVVVVVAAAAAEEEVVVVVVVVVVVVVVVVVVVV
VVVVVVVVVVVVVVVVVVVAAAAAAAAAAAAAAVVVVVVVVVVVVVVVVVVBBBVVVVVV
VVVVVVVVVVVVVVVVVVVAAAAAAAAAAAAAAVVVVVVVVVVVVVVVVVVBBBVVVVVV
VVVVVVVVVVVVVVVVVVVAAAAAAAAAAAAAAVVVVVVVVVVVVVVVVVVBBBVVVVVV